################[##########
.........................!o
..........@..............!o
.........................!o
.........................!o
################]##########