#####[#######[#######[#####
..........................o
.@........................o
..........................o
#####]#######]#######]#####