################[#####[####
.........................!o
......@..................!o
.........................!o
################]#####]####