################[#####[####
.........................!o
..........@..............!o
.........................!o
################]#####]####