##########[#####[#####[####
.........................!o
..........@..............!o
.........................!o
.........................!o
##########]#####]#####]####