#[###[############[########
..........................o
...@......................o
..........................o
#]###]############]########