#############################
#.......#...#.............#.#
#######...#.#.......##.##.#.#
#.......###.........#...#...#
#############################