#############################
#@......#...#@............#E#
#######...#.#...@...##.##.#.#
#.......###.........#.@.#...#
#############################