#############################
#@......#...#@............#.#
#######...#.#...@...##.##.#.#
#.......###.........#...#...#
#############################