#############....
..#..#...#..#..#.
######...@@@#####
#.########..#####
@@@@@@@@@@@@@@@@@
.................
#.#.#.#.#########
.................