#############################
#@......#...#@............#.#
#######...#.#...@...##.##.#.#
#.......###.........#.@.#...#
#############################