#########
#h.n.i.h#
#.......#
#.......#
#.......#
#.......#
#.......#
#.@.n..X#
#########