#########
#.@P@.@.#
#.@@@@@.#
#.@.@.@X#
#########