#########
#h.s.i.h#
#.......#
#.......#
#.......#
#.......#
#.......#
#.@.s..X#
#########