##################
#.@.@.@.F...|..###
#.@@@@@.#...|..###
#.@.@.@X#...|..###
#..######...|..###
#.......#---+--###
#...&...#...|..###
#.......#...|..###
#.################
#.######v#v#######
#...........|X....
##..........|X.<##
#>..........|X....
##..........|X.###
#######^#^########
##################