#########
#.......#
#...@...#
#.......#
#########