#########
#.@.@.@.#
#.@@@@@.#
#.@.@.@.#
#########