################
#.@.@.@.F...|..#
#.@@@@@.#...|..#
#.@.@.@X#...|..#
#..######...|..#
#.......#---+--#
#...&...#...|..#
#.......#...|..#
#.##############
#.........v.|..#
#...........|.<#
#>..........|..#
#......^....|..#
################