#########
#.@.@.@.#
#.@@@@@.#
#.@.@.@X#
#..######
#.......#
#...&...#
#.......#
#########