#########
#.E.E.E.#
#.......#
#.......#
#.......#
#.......#
#.......#
#.@.n..X#
#########