#########
#.@.@.@.#
#.@@@@@.#
#.@.@.@X#
#########