################
#.@.@.@.F...|..#
#.@@@@@.#...|..#
#.@.@.@X#...|..#
#..######...|..#
#.......#---+--#
#...&...#...|..#
#.......#...|..#
################